@@@@@@@@@@@@@@@@@@@@@@@@@@@@@@
@@@@@@@@@@@@@@@@@@@@@@@@@@@@@@
@@@@@*****@@@@@@@@@@*****@@@@@
@@@@@*@@@*@@@@@@@@@@*@@@*@@@@@
@@@@@*@@@*@@@@@@@@@@*@@@*@@@@@
@@@@@*@###@@@@@@@@@@*@###@@@@@
@@@@@*@###@@@@@@@@@@*@###@@@@@
@@@@@**###@@@@@@@@@@**###@@@@@
@@@@@@@@@@@@@@@@@@@@@@@@@@@@@@
@@@@@@@@@@@@@@*@@@@@@@@@@@@@@@
@@@@@@@@@@@@@*@@@@@@@@@@@@@@@@
@@@@@@@@@@@@*@@@@@@@@@@@@@@@@@
@@@@@@@@@@@#####@@@@@@@@@@@@@@
@@@@@@@@@@@@@@@@@@@@@@@@@@@@@@
@@@@*@@@@@@@@@@@@@@@@@@@*@@@@@
@@@@@*@@@@@@@@@@@@@@@@@*@@@@@@
@@@@@@*@@@@@@@@@@@@@@@*@@@@@@@
@@@@@@@*@@@@@@@@@@@@@*@@@@@@@@
@@@@@@@@*************@@@@@@@@@
@@@@@@@@@@@@@@@@@@@@@@@@@@@@@@